#e#####
# #   #
#   # #
#  #  #
# ### #
#  #  #
#     #
#   # #
#####s#